11111111111111111111111111111111
10000000000000011000000000000001
10000111100010000000000000000001
10000000000000000000000010010001
10000000000000000000000000010001
10000000000000000000000000010001
10000000000000000100000000010001
10000000000000001000000000010001
10000000000000001000000000010001
100S0000000000001000000000000001
11111111111111111111111111111111