NO ./textures/grey.xpm
SO ./textures/red.xpm
WE ./textures/hit.xpm
EA ./textures/symbol.xpm

F 0,0,0
C 243,196,207

11111111111111111111111111111
10000000001100000000010111111
11110111111111010000000010001
11110111111111011101010000001
11111111111111111111111111111
11111111111111111111111111111        111111
11000000110101011100000010001       11101
10000000000000001100000010E01       11111
10000000000000001101010010001
1100000111010100111101111000111
11110111 1110101 101111010001
11111111 1111111 111111111111


