11111111111111111111111111111111
10000000000000011000000000000001
10000111100010000000000000000001
10000000000000000000000010010001
10000000000000000000000000010001
100000000000000N0000000000010001
10000000000000000100000000010001
10000000000000001000000000010001
10000000000000001000000000010001
10000000000000001000000000000001
11111111111111111111111111111111