NO ./textures/symbol.xpm
SO ./textures/symbol.xpm
WE ./textures/symbol.xpm
EA ./textures/symbol.xpm

F 123,124,120
C 12,12,120
            
        1111111111111111111111
        11111111111111111111111111111111111
        110000000000000000000000001
        11111110000000000000011111111111111111
        10000000000000000000111111111
        100000000000000000000111111111
        1000000000000000000111111111
111111111011000001110000000000001
10000000001100000000010111111111111
11110111111111010000000010001
11110111111111011101010010001
11000000110101011100000010001
10000000000000001100000010001
10000000000000001101010010001
11000001110101011111011110N0111
11110111 1110101 101111010001
11111111 1111111 111111111111